26 27
0  0  0  0  0  0  0  0  0  0  0  0  0  0  0  0  0  13 13 13 13 13 13 13 13 13 13
0  0  0  0  0  0  0  0  0  0  0  0  0  0  0  0  0  13 13 13 13 13 13 13 13 13 13
0  0  0  0  0  0  0  0  0  0  0  0  0  0  0  0  0  13 13 13 13 13 13 13 13 13 13
0  0  0  0  0  0  0  0  0  0  0  0  0  0  0  0  0  13 13 13 13 13 13 13 13 13 13
0  0  0  0  0  0  0  0  0  0  0  0  0  0  0  0  0  13 13 13 13 13 13 13 13 13 13
0  0  0  0  0  0  0  0  0  0  0  0  0  0  0  0  0  13 13 13 13 13 13 13 13 13 13
0  0  0  0  0  0  0  0  0  0  0  0  0  0  0  0  0  13 13 13 13 13 13 13 13 13 13
0  0  0  0  0  0  0  0  0  0  0  0  0  0  0  0  0  13 13 13 13 13 13 13 13 13 13
0  0  0  0  0  0  0  0  0  0  0  0  0  0  0  0  0  13 13 13 13 13 13 13 13 13 13
0  0  0  0  0  0  0  0  0  0  0  0  0  0  0  0  0  13 13 13 13 13 13 13 13 13 13
0  0  0  0  0  0  0  0  0  0  0  0  0  0  0  0  0  25 25 25 25 25 25 25 13 13 13
0  0  0  0  0  0  0  0  0  0  0  0  0  0  0  0  0  25 25 25 25 25 25 25 13 13 13
0  0  0  0  0  0  0  0  0  0  0  0  0  0  0  0  0  25 25 25 25 25 25 25 13 13 13
15 15 15 15 15 15 15 15 15 15 15 15 15 15 15 15 15 15 15 15 15 25 25 25 13 13 13
13 13 13 13 13 13 13 13 13 13 13 13 13 13 13 13 13 13 13 13 25 25 25 25 13 13 13
13 13 13 13 13 13 13 13 13 13 13 13 13 13 13 13 13 13 13 13 25 25 25 15 13 13 13
13 13 13 13 13 13 13 13 13 13 13 13 13 13 13 13 13 13 13 13 25 25 25 25 13 13 13
13 13 13 13 13 13 13 13 13 13 13 13 13 13 13 13 13 13 13 13 15 25 25 25 13 13 13
25 25 25 25 25 25 25 25 25 25 25 25 25 25 25 25 25 25 25 25 25 25 25 25 13 13 13
25 25 25 25 25 25 25 25 25 25 25 25 25 25 25 25 25 25 25 25 25 25 25 15 13 13 13
25 25 25 25 25 25 25 25 25 25 25 25 25 25 25 25 25 25 25 25 25 25 25 25 13 13 13
15 15 15 15 15 15 15 25 25 25 25 25 25 25 15 15 15 15 15 15 15 25 25 25 13 13 13
13 13 13 13 13 13 7  7  7  7  7  7  7  7  7  13 13 13 13 13 7  7  7  7  13 13 13
13 13 13 13 13 13 7  7  7  7  7  7  7  7  7  13 13 13 13 13 7  7  7  7  13 13 13
13 13 13 13 13 13 7  7  7  7  7  7  7  7  7  13 13 13 13 13 7  7  7  7  13 13 13
13 13 13 13 13 13 7  7  7  7  7  7  7  7  7  13 13 13 13 13 7  7  7  7  13 13 13