50 56
0  0  0  0  0  0  0  0  0  0  0  0  0  0  0  0  0  0  0  0  0  0  0  0  0  0  0  0  0  0  0  0  0  0  0  0  0  0  0  0  0  0  0  0  0  0  0  0  0  0  0  0  0  0  0  0
0  0  0  0  0  0  0  0  0  0  0  0  0  0  0  0  0  0  0  0  0  0  0  0  0  0  0  0  0  0  0  0  0  0  0  0  0  0  0  0  0  0  0  0  0  0  0  0  0  0  0  0  0  0  0  0
0  0  0  0  0  0  0  0  0  0  0  0  0  0  0  0  0  0  0  0  0  0  0  0  13 13 13 13 13 13 13 13 13 13 13 13 13 13 13 13 13 9  13 13 13 13 13 13 13 13 13 13 13 13 13 13
0  0  0  0  0  0  0  0  0  0  0  0  0  0  0  0  0  0  0  0  0  0  13 13 13 13 13 0  0  0  0  0  0  0  0  0  0  0  0  0  13 9  13 13 13 13 0  0  0  0  0  0  0  13 13 13
0  0  0  0  0  0  0  0  0  0  0  0  0  0  0  0  0  0  0  0  13 13 13 13 0  0  0  0  0  0  0  0  0  0  0  0  0  0  0  0  13 8  13 13 0  0  0  0  0  0  0  0  0  13 13 13
0  0  0  0  0  0  0  0  0  0  0  0  0  0  0  0  13 13 13 13 13 13 0  0  0  0  0  0  0  0  0  0  0  0  0  0  0  0  0  0  13 8  13 0  0  0  0  0  0  0  0  0  0  13 13 13
0  0  0  0  0  0  0  0  0  0  0  0  0  13 13 13 13 13 0  0  0  0  0  0  0  0  0  0  0  0  0  0  0  0  0  0  0  0  0  0  13 9  13 0  0  0  0  0  0  0  0  0  0  13 13 13
0  0  0  0  0  0  0  0  0  0  13 13 13 13 13 0  0  0  0  0  0  0  0  0  0  0  0  0  0  0  15 15 15 15 15 15 15 15 15 15 13 13 13 0  0  0  0  0  0  0  0  0  0  13 13 13
0  0  0  0  0  0  0  13 13 13 13 13 0  0  0  0  0  0  0  0  0  0  0  0  0  0  15 15 15 15 13 13 13 13 13 13 13 13 13 13 13 8  13 15 15 15 15 15 15 0  0  0  0  13 13 13
0  0  0  0  0  13 13 13 13 13 0  0  0  0  0  0  0  0  0  0  0  0  0  0  15 15 13 13 13 13 13 9  9  8  8  9  8  8  13 13 13 8  13 13 13 13 0  0  0  0  0  0  0  13 13 13
0  0  0  13 13 13 13 13  0  0  0  0  0  0  0  0  0  0  0  0  0 0  15 15 13 13 13 13 8  8  9  9  8  8  9  8  8  8  9  13 13 9  13 13 0  0  0  0  0  0  0  0  0  13 13 13
0  13 13 13 13 13 0  0  0  0  0  0  0  0  0  0  0  0  0  15 15 15 13 13 13 13 13 8  8  9  8  0  9  9  8  8  0  8  8  8  13 9  13 0  0  0  0  0  0  0  0  0  0  13 13 13
0  13 13 13 0  0  0  0  0  0  0  0  0  0  0  0  15 15 15 13 13 13 13 8  8  9  9  8  8  9  8  8  9  0  8  8  9  8  0  9  13 8  13 0  0  0  0  0  0  0  0  0  0  13 13 13
0  13 0  0  0  0  0  0  0  0  0  0  15 15 15 15 13 13 13 13 8  8  8  8  9  0  9  8  8  9  8  8  9  9  8  8  9  8  8  13 13 8  13 0  0  0  0  0  0  0  0  0  0  13 13 13
8  13 0  0  0  0  0  0  0  15 15 15 13 13 13 8  8  9  8  8  9  8  0  9  8  8  9  8  8  9  13 13 13 8  8  8  9  8  8  13 13 9  13 15 15 15 15 15 15 0  0  0  0  13 13 13
8  13 0  0  0  0  0  15 15 13 13 13 13 13 13 13 13 13 13 13 13 13 13 13 13 13 13 13 13 13 13 13 13 13 13 8  9  8  8  13 13 9  13 13 13 13 0  0  0  0  0  0  0  13 13 13
8  13 0  0  0  0  0  13 9  13 13 0  0  0  0  0  0  0  0  0  0  0  0  0  0  0  0  0  0  0  0  0  0  13 13 13 13 13 13 13 13 8  13 13 0  0  0  0  0  0  0  0  0  13 13 13
8  13 0  0  0  0  0  13 8  13 0  0  0  0  0  0  0  0  0  0  0  0  0  0  0  0  0  0  0  0  0  0  0  0  0  13 13 13 13 13 13 8  13 0  0  0  0  0  0  0  0  0  0  13 13 13
8  13 0  0  0  0  0  13 8  13 0  0  0  0  0  0  0  0  0  0  0  0  0  0  0  0  0  0  0  0  0  0  0  0  0  0  0  13 13 13 13 9  13 0  0  0  0  0  0  0  0  0  0  13 13 13
8  13 0  0  0  0  0  13 9  13 0  0  0  0  0  0  0  0  0  0  0  0  0  0  0  0  0  0  0  0  0  0  0  0  0  0  0  13 13 13 13 9  13 0  0  0  0  0  0  0  0  0  0  13 13 13
8  13 0  0  0  0  0  13 9  13 0  0  0  0  15 15 15 15 15 15 15 15 15 15 15 15 15 15 15 15 15 0  0  0  0  0  0  0  0  13 13 13 13 15 15 15 15 15 15 0  0  0  0  13 13 13
8  13 0  0  0  0  0  13 9  13 0  0  0  0  13 13 13 13 13 13 13 13 13 13 13 13 13 13 13 13 13 0  0  0  0  0  0  0  0  13 13 8  13 13 13 13 0  0  0  0  0  0  0  13 13 13
8  13 0  0  0  0  0  13 9  13 0  0  0  0  13 9  8  8  9  9  8  8  9  9  8  8  9  9  8  8  13 13 0  0  0  0  0  0  0  13 13 9  13 13 0  0  0  0  0  0  0  0  0  13 13 13
8  13 0  0  0  0  0  13 9  13 0  0  0  0  13 9  8  8  9  9  8  8  9  9  8  8  9  9  8  8  13 13 0  0  0  0  0  0  0  13 13 9  13 0  0  0  0  0  0  0  0  0  0  13 13 13
8  13 0  0  0  0  0  13 9  13 0  0  0  0  13 9  8  8  9  9  8  8  9  9  8  8  9  9  8  8  9  13 0  0  0  0  0  0  0  0  13 8  13 0  0  0  0  0  0  0  0  0  0  13 13 13
8  13 0  0  0  0  0  13 13 13 0  0  0  0  13 13 8  8  9  9  13 13 13 13 13 13 13 13 13 13 9  13 13 0  0  0  0  0  0  0  13 8  13 0  0  0  0  0  0  0  0  0  0  13 13 13
8  13 0  0  0  0  0  0  0  0  0  0  0  0  13 8  8  9  9  13 13 13 13 13 13 13 13 13 13 13 13 13 13 0  0  0  0  0  0  0  13 9  13 15 15 15 15 15 15 0  0  0  0  13 13 13
8  13 0  0  0  0  0  0  0  0  0  0  0  0  13 13 13 13 13 0  0  0  0  0  0  0  0  0  0  13 13 13 0  0  0  0  0  0  0  0  13 9  13 13 13 13 0  0  0  0  0  0  0  13 13 13
8  13 0  0  0  0  0  0  0  0  0  0  0  0  13 13 13 13 0  0  0  0  0  0  0  0  0  0  0  0  0  0  0  0  0  0  0  0  0  0  13 8  13 13 0  0  0  0  0  0  0  0  0  13 13 13
8  13 0  0  0  0  0  0  13 0  0  0  0  15 13 0  0  0  0  0  0  0  0  0  0  0  0  0  0  0  0  0  0  0  0  0  0  0  0  15 13 8  13 0  0  0  0  0  0  0  0  0  0  13 13 13
8  13 6  6  6  6  6  6  6  6  6  6  15 13 13 0  0  0  0  0  0  0  0  0  0  0  0  0  0  0  0  0  0  0  0  0  0  0  15 13 13 9  13 0  0  0  0  0  0  0  0  0  0  13 13 13
8  13 7  7  7  7  7  7  7  7  7  7  13 13 13 0  0  0  0  0  0  0  0  0  0  0  0  0  0  0  0  0  0  15 15 15 15 15 13 13 13 9  13 0  0  0  0  0  0  0  0  0  0  13 13 13
8  13 7  7  7  7  7  7  7  7  7  7  13 13 13 0  0  0  0  0  0  0  0  0  0  0  0  0  0  0  15 15 15 13 13 13 13 13 13 13 13 8  13 15 15 15 15 15 15 0  0  0  0  13 13 13
8  13 7  7  7  7  7  7  7  7  7  7  13 13 13 0  0  0  0  0  0  0  15 15 15 15 15 15 15 15 13 13 13 13 13 13 13 13 13 13 13 8  13 13 13 13 0  0  0  0  0  0  0  13 13 13
8  13 7  7  7  7  7  7  7  7 13 13 13 13 13 0  0  0  0  0  0  15 13 13 13 13 13 13 13 13 13 13  8  8  9  9  8  8  9  13 13 9  13 13 0  0  0  0  0  0  0  0  0  13 13 13
8  13 7  7  7  7  7  7  13 13 13 13 13 13 13 0  0  0  0  0  0  13 13 13 13 13 13 13 13 13 13 8  8  9  9  8  8  9  13 13 13 9  13 0  0  0  0  0  0  0  0  0  0  13 13 13
8  13 7  7  7  7  7  7  9  8  8  13 13 13 13 0  0  0  0  0  0  13 13 13 13 9  8  8  9  9  8  8  9  9  8  8  9  13 13 13 13 8  13 0  0  0  0  0  0  0  0  0  0  13 13 13
8  13 8  7  7  7  7  8  9  8  8  13 13 13 13 0  0  0  0  0  0  13 13 13 9  8  8  9  9  0  0  9  9  8  8  9  13 13 13 13 13 8  13 0  0  0  0  0  0  0  0  0  0  13 13 13
8  13 8  8  7  7  7  7  9  8  8  13 13 13 13 0  0  0  0  0  0  13 13 13 9  8  8  9  9  8  8  9  9  8  8  9  13 13 13 13 13 9  13 15 15 15 15 15 15 0  0  0  0  13 13 13
8  13 8  8  9  9  8  8  9  8  8  13 13 13 13 0  0  0  0  0  0  13 13 13 13 13 13 8  9  9  8  0  9  9  0  13 13 13 13 13 13 9  13 13 13 13 0  0  0  0  0  0  0  13 13 13
8  13 13 13 13 13 13 13 13 13 13 13 13 13 13 0  0  0  0  0  0  13 13 13 13 13 13 13 13 8  9  9  8  8  9  9  8  13 13 13 13 8  13 13 0  0  0  0  0  0  0  0  0  13 13 13
8  13 13 13 13 13 13 13 13 13 13 13 13 13 13 0  0  0  0  0  0  13 13 13 13 13 13 13 13 13 13 8  9  0  8  8  9  9  13 13 13 8  13 0  0  0  0  0  0  0  0  0  0  13 13 13
13 13 13 13 13 13 13 0  0  0  0  0  0  0  0  0  0  0  0  0  0  0  0  13 13 13 13 13 13 13 13 13 13 13 13 13 13 13 13 13 13 13 0  0  0  0  0  0  0  0  0  0  0  13 13 13
13 13 13 13 0  0  0  0  0  0  0  0  0  0  0  0  0  0  0  0  0  0  0  0  0  0  0  13 13 13 13 13 13 13 13 13 13 13 13 0  0  0  0  0  0  0  0  0  0  0  0  0  0  13 13 13
13 0  13 13 0  0  0  0  0  0  0  0  0  0  0  0  0  0  0  0  0  0  0  0  0  0  0  0  0  0  0  0  0  0  0  0  0  0  0  0  0  0  0  0  0  0  0  0  0  0  0  0  0  13 13 13
13 13 13 13 0  0  0  0  0  0  0  0  0  0  0  0  0  0  0  0  0  0  0  0  0  0  0  0  0  0  0  0  0  0  0  0  0  0  0  0  0  0  0  0  0  0  0  0  0  0  0  0  0  13 13 13
13 13 13 13 0  0  0  0  0  0  0  0  0  0  0  0  0  0  0  0  0  0  0  0  0  0  0  0  0  0  0  0  0  0  0  0  0  0  0  0  0  0  0  0  0  0  15 15 15 0  0  0  0  13 13 13
13 13 13 13 15 15 15 15 15 15 15 15 15 15 15 15 15 15 15 15 15 15 15 15 15 15 15 15 15 15 15 15 15 15 15 15 15 15 15 15 15 15 15 15 15 15 13 13 13 6  6  6  6  13 13 13
13 13 13 13 13 13 13 13 13 13 13 13 13 13 13 13 13 13 13 13 13 13 13 13 13 13 0  13 13 13 13 13 13 13 13 13 0  13 13 13 13 13 13 13 13 13 13 13 13 7  7  7  7  13 13 13
13 13 13 13 13 13 13 13 13 13 13 13 13 13 13 13 13 13 13 13 13 13 13 13 13 13 13 13 13 13 13 13 13 13 13 13 13 13 13 13 13 13 13 13 13 13 13 13 13 13 13 13 13 13 13 13